mgz: mbb
bll: chq kss
knv: vrs gvd hcf
lxq: kpc
dvn: sfp rbx
gss: pfp dts hkg rvr
bqv: mjc bmn jlt
txs: fpv vrn
qpn: tvx
vlh: lns vbx
hsd: rts trh kdz
crj: tml qvk zvj jcb
dnt: bpc vmz
hsv: hqp fth djt
tjq: grs tpp pzd jkz
rbz: tbb bcm pjp sgm
vfg: gjc jnm hzd pdt
szg: fpt qxc dqv jbp
vjx: dtk lzz
kjj: kxb cqs
hzs: clk gdv
knq: hbk nsm
dsp: kpj frb bck tgv
clx: sfh jnm
ncb: rhp ghk
fth: fxm
vbl: vjh jlt rmf kdh
hvb: gvn zmk hdp nmf
fmp: ccn fjn mkd nxh pcz clt
ktr: fxm xgf
slr: dnz dnt dhz ggm
ckf: vzc fnv
pfh: sbx hzf vpp dhm dgh
mbk: kxb
svf: xxc
pgt: pbl
shq: fxj szx zhg
bnl: pbl qsk mrz dnk znf
rjx: gpn
xzt: ptk
jbl: chq
cjp: vqh khh
csz: jmn chq vpj jxr
pjc: pdc xqt sbh
bkz: cfg clb
dtb: fmb vsb qfg lcr
zmb: thk
gch: njt
cfx: tgn vfc shr
vbr: rxf
xkv: kgg
cmd: rtn
ffr: cpm znh mqz
mcq: vml tgc lth gfb
jtv: pdt
brd: ggc
xjs: rnd xcx hvv rpc
njh: tqq kzx tnv ghc
dvm: sjv bmb kzk
fmm: hgp xgz vxq bxz
vjn: hlg cpx fcp qqr
qlf: rtn vlt dln vpv
jpv: ntx fgg bhg
bbm: mnl
hjz: mhr dcg xtc
dhf: hxj qxh ncb cjs
xxq: rrd ffg ndx glq
tgn: fpp
lzr: hpm lsr jkq tms
dtz: bhg rmf bjf
jrm: vxn
khj: sdp bcj dcm lbl
mvv: rnn thk tcl kkn
zjn: qxp qdf bpd
ztg: lzx nmt dmg
dlm: hzm szx cgn xxx sfh
zft: sbx tsx qfx qlt
xvk: kch tcp nqp vxk
zxq: mbb dcm
zlq: knl hpt qhv fpn
nsm: vpp
sgq: hgg hcs kdq pjb jjt
tvc: flm
nlk: vtl fjn khh
lmb: fzh ghz dtb vqx
mtq: llz bqz
qbf: qnk ztv gvl
mgg: qqb vbv
fsm: jtm
bcm: lnp fcc
ldp: hcg
gsk: lcg dkt
jbf: vgp lvk
qcz: tbh crj qgk kmd
xtm: cng xhv nkr cfg
nmn: bxn bqc tmt
frj: gnt jkq cpx jpl
qkk: bjb bpl hgp rvr
grk: zfs qxh
lzl: jdh
czl: tjq vcg bcn jhs gzq
qcn: jpk pcn bmj
rnb: tdk thk
xjl: xrd lkm kgm psr
nqb: zhn
slg: ttv bqj prs
vfx: ptn
bsv: bcp prs dbr smc ksb
rpf: mcb hfd
sbk: mrv
hfp: ccn rfp qjg
rlk: cfg
pqh: mhr dln ltt
pxz: cfg mhb
kdz: tqs shr
zzj: qlx zvl jjz nmt
ddv: vgd dbt
lqn: sdz kzk tmz vsr
bkc: jrm nbx rjx
hnn: jhx
hxs: sfp flz tch
jjn: skm bts vcg kvf
tkm: pcz rmc nfb bhc
fbx: qlz rnx hch
jdg: kzd cmd ggp
ghz: ndx
fhk: jzc bhk kdc vch mdm
szc: cbh
bhg: mnp
jlg: cfx lzz dxt fnv
gzj: dbn
hfb: bcb dhn
frh: nlv tpp qjn jst
jxz: cbm bbm qpz xhv vml
jgn: pxp kjj sqv ztj
fdm: tbc nfh gnn
vfk: hhr zzv nxz htl
hlm: ghk
vpj: gbh
nfd: qfx vhp hrb tlt htq
ktp: jgm
ngb: gdd xxb jzl
bhc: tkv lcv vml
qpv: ccs cxb
bbc: xpn
dnk: djg vpp
knl: lrr bcp qmn hsd
bgj: ltm kcj dzj tjp cxk mbz hkk
plg: mlj txk
tbg: nxj qmb
dcc: snb grk jml
jkq: vfb cxd trr ctx
dcg: jzl hzm
bmn: zxc vsl
dvd: ghk xrt dkt
ttg: vgq
rmx: rvd zjd jkp jdg
ccs: vbv
tqp: vsv mqj tdz cbm qnf
dlh: ktp
rqc: jkd hgg
bkd: vmz kfh gzj
ssf: tjz dtl smp
ttr: kpc qmz
kmg: ljp npx
xrp: zhd
kdq: xch xzt fzh
qgk: pht jjz ckf
rnd: czh
fnt: zdb cgb fjx
tpf: bxk
ztj: ccs ssc
czq: cgn dcg rlt kgx
tld: ctf
qnr: tqk ckf
nsr: vgp mdd
tzr: shr
ksq: qzk nfb
rdq: qhv vbx
xnc: mdm djx lcg kcz
mnr: ktx
kqq: tgn kjj dpz qbk
rll: pxx
nzx: ncf tdv mfc hmr
ctl: mmk zxc qmr
frs: zqx
jxl: nlv
dhz: vps bmj tsx mbc
bqj: tvx svf
tbc: fll
trl: srg vcz pdt nlz
bcp: bjz
jkd: bxx
dmj: xpr bbm xkv
qhf: nlv nfx gvt thl
zsn: hch llz gvl
zmg: bvg zsp nfd jvx
njt: nsm kkl
tkv: zrd zmz ldp
zzs: vzc pps lln dmg
rts: dtk kgz
glx: dhd tms hjz vgc
hkz: cmk hnp hxt
tcl: gbh
skh: ccb ctf qvg
cds: ncf
vdj: cds mnq sgm fcc
plm: trh fkr
qkb: vnl jst
jlk: zbx zrd tbc gvd
xnz: blq rgr tvx qkg
jvv: zmb hfb brh djt
vxj: jst
phf: spr vlh blp png
mqt: stc
hpn: qck vjx gfs bqj
prt: bcn rsp tkv kpj
qbs: dbp xrp gvd
fpt: kxb
bnt: ghz dzl bjr rxn zmf
fmn: bqz clk dbg
fnk: dqz hxj
qmq: nqd bmn gbg kvz
rkm: fll qbx cgz
lpk: xqv xkv qrt ccv bsc bnb
sdb: kct jzb
chq: dnk cqh rbc
dkt: kch ghc btt
lhv: qpn
mhr: nqd
qmn: hlm dqq dxr
phb: brx pxz mnr ndp
vcz: lkm
rgq: hgp xtp tzf sbk
blq: kjj ght lvk
njv: jsn
tfk: lch ckn zvt
lxf: mtq vrs qvg mvx vtm
lth: mfs vmz
djk: zbh lxt rfq bkp
jll: dqz gdc vlt bgm
xdx: vsd mrv vcg pjv
mpm: bsk
lbv: gbj qpv dxt vlt
mvj: tqs zvl
shd: jhr
zrd: czh rpr tbq
fpk: hcs nvr gnt fkr
zvj: gjc lcr dbr
stt: ghk rqh jkq nlb
rsp: sgj ctf xvj
cqh: vqh dnz xgl gds
xtp: vcg
hsz: bjf xvv vcz srm klr
hsp: hmh tmt tfk
lxp: njk qms bjz srb
fpd: bhz tmz kss
tgs: vsv gxx rfp xsj rxt
ntb: xvm pqx
gzq: bbc cbh
ssk: crh cjp gbh bsr dlr
hqh: jtv
sqz: pcl rsr scf zmz qjn hmv
dmd: pfp kzb gdv
qrt: xrp frs htm jzg
hph: qnr jdg
lrn: str vzc zvk
tmr: kgz dxt hph ztg
qfg: cfx cmq fmb qxh jlm gfg
rxt: brz nfx lzk
lpr: blp jdh
lzk: vps bxm
zth: ssc qpn hsn tjp
mbz: fnl cnt
nht: lmk xvv hjz ttr
vqm: bll nfl kjh ggc
nng: mqz ktb ktn hxf zmb
ftc: xpn qfd
mtm: rvr vtp lpn zhb zrc
svp: dvn mgg jjz
dpr: vnl
klj: cgx ztl jrm
gsv: tld gvq qdv tlt rzd
rvs: ccb
kdh: gsm
njk: lzl fxj qfm jtv
xgb: qns phc zxq zct
slz: tgn mmk nmf rdz mnp
nkr: pgk
zxp: pht
xvv: xdg hfh
qnf: kzk
trh: cxd vdd
rbk: vnl
fmb: rvd
xxb: pxd
kjh: htl dpr
qzm: rtv zxq
gmd: zzv spk mqv pfp qts
mtd: dcd xpx fsn
tnv: mdm
grs: clk
bvm: jgm sbx qkt
vlt: vgj pnh
krg: kkl hpq nfb pzd dzh qpb
mvx: lth
qsk: vtm
bbx: njv mfs gvd tbq
hhk: pzz qnr
snv: dbv tdz gdv zhc
qfj: jsn sfz qtv jsh
tzq: gsk zfs
psc: vzt xrj htc rxf
vkf: thl qbv fgq vpd
hbb: qpz cng
ljq: mtz mlz vxn
lcg: tbh ggp
pfs: nqd nvr
zsz: zhd bhv
cjs: bhq
xsl: gbg
bvr: jml qpt mpm
xcq: hdn pqd lxk xbc rsk
gvt: gpr
jhs: nqb
qzr: qpt
qfd: spn tdk
tmc: nqx bbc
dbp: cbx
ndz: gtr xgm vsl lbz
rnx: xjc gdj rlk
cxk: gdc
lnq: ktp spn
mtt: gvn hcx
jqn: fzq xfl hnh
pqs: xtq xbv kct
jkb: rbk spb
zct: szc
znx: llz tgc lpq khj
spr: bgm
pqd: dtn gtr
qfx: bxz
gfg: zvk
bxj: gbj vsl xrt xrd
tpp: mqv
ngc: gqr lmr vts mqz
xzk: pgt tqp spb mqv
plt: trr lzl vjh pht
kpc: hzm bhq
slb: brd mvs
jbp: qms mjc
mgm: chq gnz clb
htc: rrp rxf
fps: khc
ndp: zrc htm
zsp: vtm hdm
xml: flb hnn rpf shx
msb: lmk
qns: vpj rfj ggc
qts: smb dhn pnx bxn
lcp: vpp vtl ztv nhl
vhx: pqx pxz vps
zgv: rns cls jpv gpc
qhm: hcg
jcd: pbl
dtl: zhn dkj
tzf: gxq
vgc: lkm mbk vcv
qvk: pxd bxx rqc
hpt: fpp
lkm: vmk
zdb: kgz
dgh: xsj xgz
csj: dbm shx
ddz: vmj cqs lzd
bbz: vhz gcf dmd xzk
sbh: qqb
kxx: pqd lzm xfl fnk
xmr: gfb ktz xmm xrp
ltt: nsd mpm tzr
hbm: szz bjb
qrs: xgz hfc bkc
rlt: cxk vlh
bzb: tgv ckl ktr
btp: snb znt vbv mcm
qpc: nnj kjh pfh nhp
fht: qlz thk zsn zhn mdv tdz
rkh: gcv tdz fxm
cmk: clx pps stn
jml: lhc nlb
pdg: phc hvx qdc lnq txs
vtl: zrc
qrm: pxd
ctx: kdh
nhp: vrs tzj
dlx: kgg
knb: gnk kcf tzf tzt htm
lpd: qqr qrq xzm
jlm: kch gbj blb
hrb: mgr
prk: gpz zlt clx
ljp: cmq lbz bcx
jtg: tvn
tpq: rll lpg htc hfv nbp
jcv: cgz gxq
hkg: mtz vmz
fjc: jpl qvq qhv nxj fpp svp hkk
xpr: mqz czh
qxm: thl xpk zdv gfb
rsk: kfs gjc dqq
vrs: ppg
nlx: vpt
bfh: rll pck xdh
kvh: nmt
xrd: ghc vcv
qck: gdd
vlv: ckn gzj ktb vjc lnq
hqp: lqr
vmz: mhq
hfc: dlv vnl rvs
kpg: psb ccb tzf lvf cft
cdf: bhv mvs gzj
gxx: hpz
skz: zhn kgk sll hzs
qbv: gpn dlt
shl: blr tcn fvn
pzt: gnt ttr vmj
flt: sll xpk
nmf: qqb kvh rhp
fkk: pvd thl xrq jbl
lvk: vgj
dlt: jgm
gvh: vqh
tcg: bnb rlk pnx plg mxb
snn: lhv bcp jcl rgd
szx: hcs clq xsl
jrg: cgb klr xgm
zql: tkc ccv
zpp: xgm gvn nlx
lvp: gcd fps qpc sjv
stn: ctl
ggk: gpc hfh tbg fsm
fhb: zmb zhb
bpc: fxm rfj cch
rfq: lsk phf jbf
pzd: bxg gvg
nlq: ddv xpk
txj: fkr cxk hgk
llh: vgq hbm vsd
rrd: rmf vtb tqs trx vzt
rfx: tmz djg gvq
rtv: lqr ggm
cgn: tqk
psn: bmj grs qfd vhz
vhr: kdh sqd vzt sfq
vjh: xsl dqv
lrb: vqx lnp shq
dxr: qnl gpc
tbk: cqs
mtx: mvs ppg hdm
kgz: jdh
rqt: qdf kmg vdh fdt
bls: bvg nqx nfl qxz
rfn: snb bgm gqp xbv
cgz: chx
fcp: jqn klr
xrn: jft mtd fnt ptk bpd
bmj: szz
dcd: xxk
rxn: mnz ksb hmr
mmx: ksx gch vxr kzk
bxn: tzj mbc
djq: ktz
znf: qkt dpr
dct: kpj kbd hrb sxm dnh
bnh: sfq rrm kfs vdh
vzt: gdc
gms: csg tzr smc vjx
bjr: npx nsr znt qmb
gbl: mrx fnv bcg
xvj: lms
fvb: jlg tvj gbl prs dkp
ngk: qhm kbf tcl
sdk: mhj vrx smb nfb
jxx: blq jzb kkm
tls: bls vqg mfs tfc
hgb: dmg qlx
smb: lzk
rbr: rjx gxx kzq
ffg: jcl ptn jdj srg
jfv: fgx rbr dbp dbg
dsg: brh
djn: mtq shx dtl
lhc: rtj
hvv: rnb bjb zgb cbl
vxq: tkc
dlr: zqx ktp
hbg: pnd crj qgk bfq fcc
kss: rbd
rzt: mdd qvq
kqz: vtz fmn mnr bkz
rfp: rnd tlt
pnx: tgv vhp jpk
mcm: srp rsk ptn
rqr: txs xdx fdm lpn
zrj: zjm bcb
ktx: nxz
xzb: shn rlt jtv lxq
nkn: dhm ppp hqp nfb bcb
knp: kfh njv stc nkn knq
gnk: dlt sqf
qbn: gqb dqv krm kkm znt crn
dtt: zjk sqv frr lxk zbh
vdk: fzq mrx cds qkl
qcg: vhx dsm vgq hbt shl
dzj: lxt lln msb
bsc: llz psb
qjt: gvh bsb
dbm: bqc
htm: fvn rlk
sjv: dbm ktx
mnz: mgd hgg xzt
xvm: rrf fqv
mlz: rrs ftx zvt
plp: gjc llg zjd xqt mdd hxj
tdv: ztn zxv flz
lqr: ppg ckl
ljt: jhr lqr lsb qdc
pqb: rrp
kdc: str
xcm: gph tcn rrs plg
ftb: jhx
ktc: czq zmk xkm tpq jkd pql
pfr: rbx nxj plm
rgb: jtv xxx
blp: lzx jxx mnp
qbk: zhg dmh
ctt: xjr xlq
tkt: xgm qmr
vhp: flt hvx kbd
kbd: qbg
xzm: nlx vpt
hxt: vcc stn nrf
pzx: vpq prd qfj npp ctt
gpr: tmz
fxt: nps ccn mkp ntb qzm pbl
gfs: mdm
pdk: lvf hhr jbl bll
nlz: dmg
txk: xjc
kgg: vml
sjg: qrm pxx jtd
gsm: nlb
jtk: rzt lhv hcx lln
frr: rtn hgk
bkp: lhc psr fsm
bfr: hqh zjn srg rts
hbk: dbt
sxh: zbh mdm
jzd: tgv
mfc: ttr qck
qdf: cgb kkm
vgz: mtq plg tzj
llg: ztn qjj
nhl: tcl jcd nrx
stl: dkj
hdp: tbk nqd
fsd: hkz fzq jln stn
stc: qhm
kkn: bsb zrj sxm tlt szc
nhb: dkp str bjz csk
grj: nbx fnc
dts: bck szc hzs
ksx: qvg zzv
qqb: kzd grk
qpl: mhs lcg lkp xfc
ftj: ssc fzh tnk
zmk: sfp btt
vkx: ntx psr xpx
gpz: vxj bdn
rdz: nbp fpp
zgf: tgd cjb fbn mrx
xsj: vtp
jbs: lhc pqb lgq zxp
rpr: lzk
vfb: vsb qlx
lsf: vrm zzf mcp
ldz: bqz fmn rkh
bhk: mbk lhv pck cgb
mdv: dbv gjm
bkk: mvj kfs vsl xrj
ftx: grj bdn
gtr: pzz rbx knd xch
xhc: dlx zfl
txz: ggm ctf lvf cpm
bcx: qxc bqv
vkn: qpt rvd
qjg: fps clk fnc
qlx: frr
tqb: shd bqs bxk vtz mqq
mfp: svf rlb
xgl: ldp mhj
smp: vtp
gds: mtz
ndx: xrj
hsg: jbp lxq npm xgm
pvs: mnl vrm
cpx: cqs
ldf: qkb mgz
tlc: rll tml cgn
bdd: pvs dtl prd cnr
khd: gvl rpr dbm mhq
jts: tbk pjb qqr
hpm: sbh
ptk: ncf
kgx: str
hnp: kgm
zmx: kmg lgq pfs qkv
qvc: zjk nht jzc
sdp: ktz
hhr: hxd
vtb: ghk str zlt
vmh: dpl sps fdt lns jph lcr dln
gcd: khc rvs cbx
xbc: ndx hpm dcd
bxc: vpt sqv fmb gfs
mnp: hfv
gtc: ssc cxb bxx
fgb: gpn flb hbm cdf
lzz: lpd
lsb: tjz rmc ktz
crh: vxj mqt qbv cgx xqv
rrm: lmk
sqd: smc
tzd: nkr cdf mvx shl
dzg: cgz qjt hpd
tqq: jqn npm cgb
mrp: rcm qrs zzf dcm
hvx: dlr nrx
cnq: qsn cxd
ffl: hpv jmr cng
gdv: jgm
jvx: qbf qzm nfx
vmj: pnh
flb: zbx rvs
qbx: kzb qbv
sff: ndp mkd
lxt: pps grk
xmm: brx rnn
bjh: vch djx gqb
rtc: mrh slj kbh qbv
gxq: ktz
ztf: tbb hfv gdc vbr
szr: ggt nfx
xlb: vjh xrt qcz zmf
vcn: hcf nsm tls tqp
jlf: vdh kgm krm kgx
nfh: hch
khp: fpt fnj kvh hhf jtd pqs lzd jtm
ncp: hmh zbx ctt cbm mls
xsh: lxg ktx vqg shx njv
fsn: rdq tzq hjz
gsl: mgm gvd qmh clt mlj
rgs: tnv hlm fnk
rpm: lsr tml
dxh: rzd crh lqr
qsn: nlb
ltc: bnb nxz xmm pcl
rns: xch ppn
bmb: gdj brh
dnh: mls mqj
xqt: jtg rpm pzz
hmr: fjx rtn
zgb: bxk xlq msr
cvt: qzr nmt fqm
qlh: ncf hlm vcc hdn
glq: mfp hnp tqs
bcn: zsz
dxl: rbd
hbn: nxz
jxr: gjm qdv
sfq: str xdg
pjb: trr
rtj: nlz fkr tvj
xkm: fbn rqc kdc
cft: lzk gvg
qpz: gjm gvg
jjp: qtv bpl kjm sbx kzb
dgd: zlt jqn vdd kdz
rlb: llg
skm: tsx dlh pvg
zhg: qmn lsr qdv
mqm: hvx sbf kkn qsk
hzf: rnb tsx
xrc: qrq mfp hgb vfc hkp
zgj: tdv pck zvk pqh hpm
vqx: qjr vsb jpl
hbp: mgz qrt fbx
pqq: sdp vpj
hhq: bjf vpv
vfz: txk jkb mcs thl kss
qdd: xkv khc nqx
pgq: gqb hnh fbn vmk
bcg: ccs
fvd: dlx hsp gph jzg jqb
gcv: gvp
cnr: gfb dxh gxq qbx
hbt: hch dbv pcl
gqr: cch qnf nrx
jcb: ksb jpl pck
pfb: hsv jhs pqq kbf
kmr: gvh mtp sxg
jmr: bjb
jzn: bhv gxx dbn djg
pnj: vbv vdh xgh lzl
qlr: dbt qbs lcv bbc
zjk: jph
tch: prs vbx rrm lzx
xpx: dbr jnm
mhs: jkp dhf ngb mfc
clq: rrp
ssd: nmn xlq ljq nrx
gps: dxl pgk bjb gpr
mlp: mnl hpq tdk rtv
pzz: jtm
pnr: vxj dnh rbc
sqf: tmt czh
xpb: tqq cxb lft pht
zxf: pfr jjz mrb vfb
gsq: rbx kkm
vjt: hcg brd xhv
tgc: shx nxh
pjl: fpv grj bvm sll nfd
kxj: ttg dpr dlx clb cbm
scf: szz vtp
vjc: zjm nbx
blb: hxj dxr vgj
ppn: kxb ntx dxr bmn
pvd: mtx qfx lch
qnk: vml
pnd: tnv lrb jcl
pht: hfv
tzt: nxh dlv xlq
hpx: jtd vxk bgm dqv dtz
bnb: vpp tkc
qxz: jdl gvh dbn
sdz: xvp jsq dgh
vcj: knd ptk
dbl: ggc cjp bzb dpr
ztl: tjz vjg spn
nfl: skh tpf
pcl: gvp
zrs: gsm kct
hmv: grj gkk
xgf: vgd
gcf: djn slj ftx
lkd: htl xvj ktp qjg hnn
dhm: dnz cbx
jtm: rxf
jmk: mbk slg prk smc
xkr: ckn khh xgf gds
rdg: hsp xcl hbp
rnn: jcv lxc jcd
qss: nfh kfh
llz: tld
kjm: djq
tdd: pvq crh bsc
kdp: hgb fsm zmr nbp
brz: hbk hmt mhq
djz: vsv slb
npx: ztn
zzq: hpd ktr ptl xhs
kbf: vxn
sxm: ktx slb
vgr: xtp dnz hqp tvc
lnp: qmb jdh
lvf: zfq
dhd: plm jkd cqs
spk: mgr vrh nlq ngk
nxd: txs mlj frs qdd kgk
nnr: vcz cpx hsn rlb
sfz: bhv mkd
jph: hlm jtd
ttv: zpp xsl hhf tgd
zbk: xpx ctx qzr mct zzj
dcm: pqq hcq
dtn: zqg qsn qxp mtt
jsh: tkc mrh
pxc: lmk zjn kvz msb vsb
fnl: rgr hqh
ltm: cmd vdd hph
mls: dbn dxl gvq
tjp: krm
hbl: vjc sdz tmc scf
dpl: jtm bjh nlb nlz
msr: mcp mtp
brb: hxs kjj fnt cgg
fbn: kzd
zmr: vfc ksb kcz
tdz: jhr rcm
rmc: khh mbc
trc: mhq szz
clt: hbb qkt
qnl: pjb tbb
hzd: kpc dbr qrm
fnd: sbh lpg vxk ddz
nlv: hcq
fgg: kpc
lhr: ktb bpl jcv
mbb: dhn
hnj: xmc jbl ljb ldf rpc
gjh: vrx xqv
bjb: sll
gnz: flm
zqg: shr vcj jtm npx
zqs: sgt xzm hpt pjc
xcg: msr dgh fth xvp
tnk: pdt mhr
mnq: dvn qmr bfq
jxh: szr vhx qtv gph
qvg: jgm
hpz: dlv tjz brd
zvr: tcn trc dkj nqx
prd: fgx gpn
dln: pxx zxp
tcp: hgk nqp jzb
gvd: rcm
xxx: ght zxv
dxt: sdb
xqv: plg
hpd: bqs cch
rqh: cmq cls rmf
tbq: grs
rgf: hfd qcn bbm csj bqz
zjd: dmh vfc sgt
dpz: pzt bcm qpn
lch: flm
hlt: gnt hsn dvd zcv qbn
bgb: vbt jtm krm ndx
bjz: pdt
mjc: zfs
srm: lvk bsk sqd
bhx: ffr qnk jxz qdv
kmd: qkv
bts: clb kvf
brx: hcq fgx
dxj: dnz gdv xjc
mvs: vjg
fnj: lqc pxx jbf jzc
bpr: hfp zfq jzg ldp vqh
flm: ztv nqx
hmz: hzn qbk ffg
vhz: hgp pgk
qjn: hpq
ptl: plg xgz dbv
ntx: tkt
hdm: qdv fxm
kbh: szz xtm vrm
shn: ctx sfh lft
gqp: hqh zst gsq
kpf: tzr hzd dqz pqb bcg
crb: qvq lhv npx jzc
pcz: bkz czh
nhc: jxr
bdn: qbg
dpk: zdb jlt lkm rdq qfm
qmh: vtm csj nps
phc: bxn fpv
nhr: fpd jrm grj pnr vpq
lzs: cch gnz fth jxr hlv
qjh: bmn jtv clx jlg
dnv: jbp bxx spr ftj tlc tjp
jdl: bmb szt qnk sfz
fmj: vkx tnk rdz cjs
qvq: lgq
pjp: gsq tkt fzq
cvd: rlb kdp qck zvk
bxp: dvn hmz gfs lpr mbz
hxd: mbc
mct: lxq nsd
zvt: zql bqc
mlx: tjz bsl rpc pvs
gzf: htl vfk rpf nhc dmj
jlr: ctl svf tvj bjf
bsk: tvx
hkp: cgn bfh vlh qnr
btt: bhg zfs
hqr: rts hnp nsd ghz
vvq: mnr bck xpr
qzk: stc bdn clk
hfs: knd gbg tbg dcd msb mrb
cgx: fgx gvt
slj: flt stl
lzx: kmd
hcq: dkj
fjx: qrq
vsd: vgd qsk
vbt: xdg
fnc: dbt bxm
djt: gds
qgx: bxg mtp xvm zfq vlv
lpg: dqq qpt
zdv: ckl zjm
hxf: ksx hzf
zfl: qfd qbg
tfc: qdd nfb
jzl: jkp
fxd: hxd xsj
sfh: fxj
cpm: hhr zrc djq rbc
vgp: lrn
qkl: stn gvn
mrb: bgm dmg
vzp: tvc lcv qtv jmr
gph: fqv smp
hgk: pck
tsz: hfd jsn mrz hbn bpr bsb
blr: tmz
zpk: zzf zxq dxj fth
vvt: znt gsk vbr
hmk: jgb hfb mnl mlj
fdt: gdd txj sjg
hcs: jtg
htq: sdp gvq pnr
zvl: ghc fgg
zmz: sxg
vfl: rkm znf gcv mjh jxr
lmg: nsr rmf jft xtc cfx
gnn: tmc cbl
mcs: hmt hpq tfc
tms: cnq pql
vrh: tdd bls bmz
kvf: xpk
vgj: hdp bgm
qpb: nqb bqs lch
pcn: plg cng
tbh: tnv nmt
bvg: xrp jcd mhb
kvs: cgg gjc cmd xjl
qtz: mvx hmt lzs ksx frs
mqb: jnm mpm
jft: qqp gpc
mzt: vxk tqk trx ltt
ghn: xhv mtx ksx mqt
mmk: srp lzm
ktb: rjx tcl jsn
vjg: mgr
pdc: vsb blb bfq
znh: szr ksq vjc
fpj: mct hzm tlc gsm
hcx: vch cmd vpv
mqq: sxg qbg
rgd: kcz sxh ghk rns
bsr: zvt xjr dsg
nbx: kzk mhb
kzx: plm fxj
nrf: zxv fbn pxd
krj: tcp lzz hpt gpv
bzk: cxd qmb sgt zxp kzx jlm
ggc: rbd
kmv: csk snb bvr dtk
lbl: vnl gjm ppg ccb
kjv: hfb brx bxk
fsf: rrp lmk ssc
sbf: pgt vps vxj
lmr: rnn ttg fhb jkz dbt
hzn: gvn
hqk: vrn ffl jhs djz
bfb: vtm zsz ftb knq hpd
hkk: rvd jcl
kgc: mvs fmm cbx ftx
gbh: jhr
cpv: hxj hdp rgs pfs
kvz: fzh vcc
sjz: vpt ptn zjk kvj
rrs: khc jxl
vdr: lcv ldf hfc nlk bqc
xxc: hfh qmz vpt tbk
bgm: kmd
gkk: kbd bxm ggt pvq
csg: hhf lzm
vrn: nhc bpl
dzt: djt kjm bkd vxq
zhc: zct rcm smp gcd
pvq: bcb ccv
hjt: dbg dzg sgj gdj
vtz: clk
jjt: nxj bcg lrn
ggm: ftb
srg: pnh zlt kdc
ccn: hfd hbn
tml: kkm
rtn: srp
mzf: spr fnl qms mrx
rhp: pxd fpt
hdn: pxx zrs
qqp: nsd
xdh: prs qrq cmq vmj
mnn: zpd jts pgq jlt gfg
mjh: hbm ckn vnl
xrj: kcz qrm
sgj: mhb hbb
gdd: tvn
bxz: mrv dlt
kvl: jgm gjh lcp vgz
nnz: bxc mgd txj
qkg: fnl kgx qqr ncb
pps: srp vbx qck qjr xxb
zhb: mgr tpf
lpq: zfq rnd qss
jnm: vpt
pzv: prk khn lzr jkp
tcj: hvb fjx nvr clq
pvg: bxz gvg fgq
zcv: lrr kjj lzd
psr: sps ltt
bsl: dzn njt frb
nvv: jdl vml qjn djn
jrp: tqs flz szg qmz
djx: trr dkp
rtz: bqz lqr zbx hxf
mgd: tbb
hsn: vcc
hlv: zzv vrs
dsm: dbg ddv qhf
vdd: tnv
rfj: mhb
qjj: nvr nbp tvn
lln: pxx
nqp: nmt
mhj: dbn
cbk: dkj tjq bnl gbv
pgd: bcx vfx rzt cds vvt
xmc: zxq rbk xjc
fpn: knd dqz lns vbt
bcj: fvn ztv
dzn: txk qss qnf
xrq: dvk szr kbf dnt
lsr: hzn pht
chx: rbd gnk szc
pjr: qfm lpr sgt ght
qmr: qfm
rzd: llz vcg
ttn: xhc brd zmz gpr dlv spn rdg
gbv: qpz gpz
szt: lqr gch vxq
xvp: rrf cbl kgg
lms: ckl
rpj: zfl kfh ggt qtj
xhs: zrj bmb lms
lsk: zrd jxl bcn rbr dvm vvq
xfl: lns
bpd: xxk rgr
hlg: sqv qqp kdq
vqh: gdj
hqs: nhp fxd ldz nlq rmc ssf
hpv: gvd rpc
lqz: tzj bsr tld kkl rrf
btk: csg jrg mdd qmr
bvd: zhd llh ftb ztl jxl dmj
dzl: kch zxc cxd
vcv: bqv
lcl: qxc lxq nnz lkp
dbv: jhx
xcx: dkj mtp
vjr: rfx vpp sxg mpv
kvj: zqg fnd vfx bhg
ggt: mdv
qtj: brx gvh
fxv: pxp sps dcc vdd
jzc: tqs
fqm: mct ncb zvl
mxb: bxm rbc clk
xcl: fll hxd fvn
xgh: zxv qms mvj
zlm: qxh vcv qjr qkv sxh
trx: xgm nmt
xmb: kmr xcx dsg gjh
jmn: jsh xhc xgl
frb: bxk rpc jmr
mqj: trc
lxk: kxb mqb
crn: jzb jtg hhf gqp
nnq: svf
bmz: dbp tvc qns
gvp: vtl
cjb: zdb zbh hgg
bhz: pgk hcf ntb
hzj: lhq rfj jhx hfd xjr
lbz: nbp
jpk: bsb dhn
nfn: qfx hmh gnz qjt
vrx: nfl fps
khn: nnq fsf vcj
qxp: ztj kvz rxf
zpd: xfl gtc
dmh: lbz mgg
cbh: lcv
qlt: jzd qtj jzg
hxj: ztn lbz
vxn: nrx
cls: zrs
mcb: ccv nxh tdk
bld: vjg hpv vmz nfb
ggp: cjs qsn clq vmk jtm
shx: mqj
pqx: xgf
bpn: vgp xvv pqb qzr
skq: xrd lhv rzt
hnh: klr jzl
dkp: bhq
jkz: djg sbx
kzb: mls
zqx: pfp cbh jhx
kkl: stl gvt
jsq: skm vrx ffl
csk: qnl gtr
xtq: hhq qkl pxp
dvk: sff pgk grj
jgb: hgp gvp nfh
npm: hhk xzt
lxg: mrh jmr dxl
vsr: hcg mhj blr
ppp: dnt pcn hdm bsl
ktn: vnl jzd fnc
mrz: kjm tpp
zrv: dsg bhc rrs tbc
zhd: lzk
kfh: hmt
jpt: hrb kjv ntb hlv gzq
fhz: hnp hhk cls vmk mtt
bqb: cnq zpd rgb sqd fcc
fnv: zbh
xdg: llg
qvs: ttg dlh lhr ftb
vts: mrv xhv tmt
thk: lms mtz
rxs: jzd bqs qdc gnn rpr gdv
vvh: vgr fgx hmv vgq
zlt: qpn qms vkn
mtj: lcr rgb dhf tvx
tvj: qqp ght
xbv: hjz qnr rgr
vxr: xjr gnk zqx zjm
kgk: hbn vxn zzf fll
pql: tvn vfx
gvj: cvt shr ctl qjj
vpd: vrm nqb mxb mfs zmb mrh djz
jpc: pjp tzq nnq qms
zmf: xxb sdb
qhn: sqf gch mnr vgd
vpq: bts blr dts
lmk: kfs
gvl: kvf
nps: nnj ftc
rsr: shd tvc hnn
vrf: spr cfx sfp pnh
jqb: xcm hkg zql
pjv: tcn knv mvs
qmz: zxc
srb: hfh vsl pfs qkv qjr zlt
gqb: jzl
kcf: qss mhq fxd mlz nfx
dzh: cng kss qmh
kgm: bsk
lpn: fhb kzq mqq vjt
mcp: rrf shd
mzm: fcp lgq xxk kzd
lrr: flz qxc
cbl: pqx djq vsv
cnt: nqp jkd nlx
lxc: gbv zsp rbk fmm
kct: bfq
npp: hbk pgt zdv stl mcb
zst: vpv rvd dqq
xpn: ckl fll
cgg: snb vbt vbv
fxq: bzk crb txj kcz nnq
dxc: dzn dhn xvj fgq nhc
lft: jzb gbj vch lzm
lkp: xxk jtk lzd
ctj: khj fqv ftc dlv
lqc: rtn gbg vsl
pxp: mqb
bnr: djn qdc tbq mkd
mkp: htq klj jkb
vxc: mjc hzn tml kvh
kcj: cxb pxp vjx
sgm: qvc lzz
mdq: skq hhq qxh xtc
bxg: bxn qkb
rvr: qlz xgf
vfc: npx gfg
jgq: spb hcf mbb
mqv: grj
sps: tqk xch
fjn: xtp
vqg: jst fgq
sxj: kpj fpv ccb mqt qkt
nnj: hdm mqj lsf
xfc: rpm xtc bjf rrm
xjj: bxz mgz ksq djn stl
jjz: qhv
jdj: klr xrt xrd
pjn: qlz shx nkr sff
tgd: vbr qpv mhr dtk dmh
jln: fgg tzr vcv blp
mpv: fqv hkg fpv
ljb: hmh gcv zct
gpv: bhq tdv vkn
bvs: gkk cft brh dlh
rjq: skm frb frh rsp
png: qvc vzc lcr
psb: sbk hgp bcj
btx: kfh smb fmp qhm
lns: mgd
kzq: vtz bqc
crp: sbk tpf gvp jgq
lhq: bxn tdk kgk
spb: bck fjn